1111111111111
1P00010000001
100000E111111
110001C111111
1111111111111
