1111111111111111111
1000000000000000001
1000000000000000001
1000000000000000001
1P000000C00000000E1
1111111111111111111
