1111111111111111111
1000000010000000001
1000000000100000001
1000000000111000111
1P000000C01000000E1
1111111111111111111
