1111111111111111111
1000000000000000001
1000000000000000001
1000000000000000111
1P000000C00000001E1
1111111111111111111
